11111111111111111111111111
1P00000C001111000000000C01
1000000000C011000000000C01
1000C000000011000000000C01
10000110000011000C00000C01
10000110000011000000000C01
10000110000011000000000C01
10000110000011100000000C01
1000011000C011000000000C01
10000110000011000000000C01
10000110000000000000000C01
100001100000100000C0000C01
10000110000011000000000C01
10000110000011000000000C01
10000110000011000000000C01
10000110000011000000000C01
10000110000011000000000C01
1C000110000E11000000000C01
11111111111111111111111111