1111111111111
1P00000C00111
1000000000C01
1000C00000001
1000011000001
1C000110000E1
1111111111111