1111111
1P0CEC1
1110001
1111111